Home=Home
Privacy=Privacidad
HRArea=Area de Recursos Humanos
Purchasing=Compras
Sales=Ventas
Engineering=Ingenieria
MRPPLanning=Planificación MRP
HRAreaIndexPage=Área de Recursos Humanos
PersonTable=Listado de empleados
Filter=Filtrar
FilterByName=Filtrar por Nombre
Name=Nombre
Surname=Apellidos
DNI=Documento de identidad
Adress=Direccion postal
Country=País
<<Prev=<< Anterior
EditPerson=Editar datos del empleado
Person=Empleados
Career=Carrera profesional
Contract=Contrato
Curriculum=Plan de estudios
Pay=Nómina de sueldos
Presence=Presencia
ObjReview=objetivos Rev
Training=Capacitación
Next>>=Siguiente >>
PersonData=Datos del Empleado
BirdDate=Fecha de Nacimiento
CityOrigin=Lugar de nacimiento
CountryOrigin=País de origen
AdressAd=Dirección adicional
CountryRes=País de residencia
ContractDate=Fecha de Contrato
EntryDate=Fecha de entrada
ExitDate=Fecha de salida
Update=Actualizar
Cancel=Cancelar
mDNI=se requiere documento de identidad
mBirD=Se requiere Fecha de nacimiento
mCitB=Se requiere Ciudad de origen 
mCtrOr=Se requiere país 
mName=Se requiere campo de nombre
mSname=Se requiere el apellido 
mAdr=Dirección es obligatorio
mConD=Se requiere campo Fecha de contrato
mEntD=se requiere la entrada de campo de fecha
OrgreaIndexPage=Area de organización 
Organization=Organizacion
Chart=Organigrama
Resources=Tecnología
Languages=idiomas
Users=Usuarios
OrgTable=Tabla de organización
OrgData=Datos de la organización
OrgCode=Código de Organización
mOrgCode=Código es obligatorio
OrgNif=Id de la organización
mOrgNif=Se requiere el campo ID de la organización
OrgName=Nombre de la Organización
mOrgName=El campo nombre es necesario 
OrgAdd=Dirección postal
mOrgAdd=Se requiere campo
OrgAdi=Postal Dirección Cont
mOrgAdi=Se requiere campo
Telephone=Teléfono
mTelephone=Se requiere campo
OrgWeb=Página web
mOrgWeb=Se requiere campo
OrgEmail=Email
mOrgEmail=Se requiere campo
mOrgCtry=Se requiere campo
mOrgCity=Se requiere campo
OrgDate=Fecha de fundación
mOrgDate=Se requiere campo
SelectLang=Seleccione el idioma
Useddltoselect=Seleccione el idioma
CharCode=Código del Departamento
mCharCode=Se requiere campo
CharName=Nombre de departamento
mCharName=Se requiere campo
CharDate=Fecha de creación
mCharDate=Se requiere campo
CharAdress=Dirección
mCharAdress=Se requiere campo
CharAdressad=Dirección
mCharAdressad=Se requiere campo
CharTel=Teléfono
mCharTel=Se requiere campo
CharWeb=Sitio web
mCharWeb=Se requiere campo
CharEmail=dirección de correo electrónico
mCharEmail=Se requiere campo
CharCity=Ciudad
mCharCity=Se requiere campo
CharCtry=País
mCharCtry=Se requiere campo
CharHName=Nombre del Director
mCharHName=Se requiere campo
Code=Código
Head=Director
CharData=Datos del Organigrama
AdChart=Agregar una tabla de registro Organización
EdChart=Editar una tabla de registro Organización
AdRChart=Añadir a Rol departamento ordanization
Org=Organización
Unauthorized=Usted no se ha identificado.
PleaseLogin=Por favor Inicie sesión
Logoff=Desconectarse
Username=Nombre de usuario
EnterUsername=Introduzca su nombre de usuario
Password=Contraseña
EnterPassword=Introducir la contraseña
Login=Acceso
_Login=Login
_Logout=Logout
Logout=Desconectarse
Forbidden=No autorizado por favor contacte con su administrador
UsrData=Datos del Usuario
UName=Nombre de usuario
ULastName=del usuario Apellido
AddItem=Añadir artículo
AdUser=Agregar usuario
EdUser=editar usuario
UsRolData=Datos Rol del Usuario
RolName=Nombre de Rol
AdRol=Añadir Rol
FDescr=Descripcion de la Instalacion
FCode=Codigo de la instalacion
FType=Tipo de instalacion
FCrDate=Fecha de creacion 
FSuperf=Superficie (m2)
FCostMin=Coste/Minuto
FStatus=Status
FStDate=Fecha de Status
FAcct=Cuenta 
FacilitiesData=Datos de la Instalacion
FLotoAss=Ubicaciones para Asignar
FStAss=Almacenamientos Asignados
FEdit=Editar un registro de instalación
FWCAss=Centros de trabajo asignados
FWCtoAss=Centros de Trabajo a Asignar
FCrea=Añadir un nuevo registro de Instalacion
-----------------M=--------------------------MATERIALS DATA
MData=Datos de Materiales
MRefer=Referencia
MDescr=Descripcion
MClass=Clase de Material
MType=Tipo de Material
MStatus= Status del Material 
MStatusDate= Fecha de Status del Material 
MDim1=Dimension #1
MDim2=Dimension #2
MDim3=Dimension #3
MWeight=Peso
MUN=Unida de Medida
mValDim=Intrduzca una dimension valida (>0)
mValWei=Introduzca un peso valido (>0)
mReq=Campo requerido
MCrea=Añadir un nuevo registro de Material
MEdit=Editar un registro de Material
------------------A=--------------------------ABOUT
About=Acerca de
AboutT1=myERP es un proyecto de código abierto que intenta crear un sistema MRP dirigido a pequeñas y medianas empresas
AboutT2=Vigo invierno 2021
AboutT3=teléfono de contacto: +34 616454045 
AboutT4=correo de contacto
AboutT5=Visite el curso de formación myERP
-----------------U=----------------------------USUARIOS
UserLoginName=Nombre de inicio de sesión
UserFirstName=Nombre
UserLastName=Apellidos
UserStatus=Estado
Reset_Pw=Restablecer la contraseña
UsrRolData=Roles asignados a este usuario
SelectEmployee=Seleccione un empleado
----------------S=-----------------------------SUPLIERS
SupList=Supplier Relationship
NIF=Identification document
SupCode=Suplier Code
SupRaSoc=Company Name of the Provider
SupCity=City
SupCountry=Country
SuplierData=Data of the Suppliers
SupCrDate=Creation Date
SupAccount=Account
SupAdress=Address
SupAdressA=Address
SupPhone=Phone number
SupemailFIN=email Finances
SupemailLOG=email Logistic
SupWebSite=Web Site
SupEDIFIN=EDI address Finances
SupEDILOG=EDI address Logistic
SupBankAcc=Bank account
SupStatus=Status
SupStatusDate=Status Date
ProductData=Product Data
AddProdRecord=Add Product Record
EditProdRecord=Edit Product Record
ProRefer=Reference
ProDescr=Description
ProDateCrea=Date creation
StatusDate=Status Date
SupPlanningData=Planning Data
AddPlanningRecord=Append Planning Record
DateFrom=From Date
DateTo=To Date
SendQty=Quantity to send
PlanFirm=Plan Status
AddPlanningRecord= Add Planning Record
-------------E=-----------------------------EMPLOYEE
CareerData=Career Data
CereerDateData=Date
CareerCreate=Create Career Record
CareerEdit=Edit Career Record
Position=Position
Observations=Observations
ContractData=Contract Data
ContractCreate=Create Contract Record
ContractEdit=Edit Contract Data
Date=Date
CareerEdit=Edit Career Data
RevisionDate=Date
CurriculumData=Curriculum Data
KnowledgeArea=Area Of Knowledge
KAreaDescr=Description
Level=Level
CurrRevDate=Date
CurraArea=Area
CurrAreaDesc=Description
CurrObs=Observations
CurriculumEdit=Edit Curriculum Data
CurriculumCreate=Create Curriculum Record
PayrollData=Data Of Payroll
PayrollEdit=Edit Payroll Data
PayrollCreate=Create Payroll Record
StatusDate=Date
ConceptType=Concept
Retention=Retention Rate
Account=Account
PresenceData=Presence Data
PresenceEdit=Edit Presence Data
PresenceCreate=Create Presence Record
Location=Location
Time=Time
ObjectiveReviewmData=Objective Review Data
ObjectiveReviewEdit=Edit Objective Review Data
ObjectiveReviewCreate=Create Objective Review Record
Objective=Objective
Rating=Rating
TrainingData=Training Data
TrainingCreate=Create Training Record
Date=Date
CurriculumArea=Area
TrainingCourse=Course
TrainingEdit=Edit Training Data