Home=Casa
Privacy=Privacidade
HRArea=Área de RH
Purchasing=aquisitivo
Sales=Vendas
Engineering=Engenharia
MRPPLanning=Planejamento MRP
HRAreaIndexPage=HR Página Índice de Área
PersonTable=pessoa Tabela
Filter=Filtro
FilterByName=Filtrar por nome:
Name=Nome
Surname=sobrenomes
DNI=EU IRIA
Adress=adress
Country=País
<<Prev=<< Anterior
EditPerson=Editar uma Pessoa
Person=funcionários
Career=Carreira
Contract=Contrato
Curriculum=Currículo
Pay=Folha de pagamento
Presence=Presença
ObjReview=objetivos Rev
Training=Treinamento
Next>>=Next >>
PersonData=pessoa de dados
BirdDate=Data de Pássaro
CityOrigin=local de nascimento
CountryOrigin=País de origem
AdressAd=adicional Adress
CounntryRes=País de Residência
ContractDate=Data de Contrato
EntryDate=Data de entrada
ExitDate=Data de saída
Update=Atualizar
Cancel=Cancelar
mDNI=ID campo é obrigatório
mBirD=campo Data pássaro é necessária
mCitB=Cidade de origem campo é obrigatório
mCtrOr=País Campo obrigatório
mName=campo nome é obrigatório
mSname=Sobrenome Campo obrigatório
mAdr=Endereço campo é obrigatório
mConD=campo Data Contrato é necessária
mEntD=Data entrada campo é obrigatório
OrgreaIndexPage=área de Organização Índice Página
Organization=área de Organização Índice Página
Chart=Organograma
Resources=Tecnologia
Languages=línguas
Users=Comercial
OrgTable=mesa da organização
OrgData=Dados da Organização
OrgCode=Código de Organização
mOrgCode=Código campo é obrigatório
OrgNif=Id da organização
mOrgNif=Campo Organização ID é necessária
OrgName=Nome da organização
mOrgName=Nome campo é obrigatório
OrgAdd=Endereço postal
mOrgAdd=Campo é obrigatório
OrgAdi=Postal Endereço Cont
mOrgAdi=Campo é obrigatório
Telephone=Telefone
mTelephone=Campo é obrigatório
OrgWeb=página da Internet
mOrgWeb=Campo é obrigatório
OrgEmail=o email
mOrgEmail=Fiel é necessária
mOrgCtry=Campo é obrigatório
mOrgCity=Campo é obrigatório
OrgDate=Dia da fundação
mOrgDate=Campo é obrigatório