HomePage=MyErp Home Page
Unauthorized=Unauthorized
EnterUsername= Enter User Name
EnterPassword=Enter Password
LogIn=Login
Cancell=Cancel
Org=Organization
HRArea=HR Area
Sales=Sales Area
Engineering=Engeneering Area
MRPPLanning=Planning MRP
Languages=Languages
PleaseLogin=Please Login
ChangePassword=Change Password
Useddltoselect=Select Language
Update=Update
Cancel=Cancel 
------------------------------------------------------------------------------------
OrganizationArea=Organization Management
OrgData=Organization's Data
OrgCode=Code
OrgName=Name
OrgNif=Tax identification number
OrgDate=Foundation Date
City=Address City
Country=Address Country
OrgAdd=Address
OrgAdi=Address (cont)
OrgWeb=Organization's Web Page
OrgEmail=Contact Email
Telephone=Contact Phone number
Organization=Organization Data
Chart=Chart Data
Users=Manage Users
Home=Home Page 
CharList=Organization Units List
ChCode=OU Code
ChName=OU Name
ChHeadName=OU Head Name
EdChart=Edit Chart
CharCode=OU Code
ChanName=OU Name
CharDate=OU Creation Date
CharHeadId=OU Head (User Name)
CharAdress=OU Postal Address
CharAdressad=OU Postal Address (cont)
CharCity=Ou Address City
CharCtry=OU Address Country
CharWeb=OU Web page
CharTel=OU contact Phone number
CharEmail=OU Email contact
CharUsrers=OU's Users members
Id=User Id
Name=User Name
SelEmploytoChar=Assign Employee to OU
Select Employee=Select Employee
UsersList=Application Users
FirstName=User First Name
LastName=User Last Name
UserLoginName=User Login Name
UserFirstName=User First Name
UserLastName=User Last Name
UserStatus=User Status
RolUsers=Roles assigned to this user
SelRolUser=Assign Role to this User
Select_Role=Select Role
Name=Rol Name
--------------------------------------------------------
HRAreaIndexPage=Employees Management
PersonTable=List of Employees
DNI=PIN
Name=Name
SurName=Surname
Address=Address
Country=Country
EditPerson=Edi Employee Data
Person=Employee
Career=Career
Contract=Contract
Curriculum=Curriculum
Pay=Pay
Presence=Presence
ObjReview=Obj. Review
Training=Training
PersonData=Employee Data
BirdDate=Date Of bird
CityOrigin=City ​​of birth
CountryOrigin=Country of birth
Adress=Postal Address
AdressAd=Postal Address (cont)
CountryRes=Postal Address Country
ContractDate=Date Of Contract
EntryDate=Start Date
ExitDate=End Date
CareerData=Data Of Employee's Career
Date=Date
Position=Position
Observations=Observations
CareerEdit=Edit Career Data
ContractData=Data of employee's contract
Date=Date
Observations=Observations
RevisionDate=Date of Revision
CurriculumData=Data Of Employee's Resume
Date=Date
Area=Area
Description=Description
Level=Level
Observations=Observations
CurrArea=Area
KAreaDescr=Description ofg Knowledge Area
CurrObs=Observations
CurriculumEdit=Edit of Employee's Resume
PayrollData=Employee Payroll Data
Date=Date
Type=Type
PayrollEdit=Edit Employee's Payroll Data
Retention=Retention Rate
Account=Ledger Account
StatusDate=Date
ConceptType=Type of concept
Retention=Retention Rate (PIT) 
PresenceEdit=Edit Employee's Presence Data
Location=Location
Date=Date
Timer=Time
ObjectiveReviewmData=Employee's objective review data
ObjectiveReviewEdit=Edit Employee's objective revies data
Date=Date
Objective=Objective
Rating=Rating
TrainingData=Employee's Training Data
Date=Date
Srea=Area
Course=Course
Grade=Grade
Observations=Observations
CurriculumArea=Area of knowledge
TrainingCourse=Course