Home=Zuhause
Privacy=Privatsphäre
HRArea=HR-Bereich
Purchasing=Einkauf
Sales=Der Umsatz
Engineering=Maschinenbau
MRPPLanning=MRP Planung
HRAreaIndexPage=Bereich Persönliche Ressourcen
PersonTable=Mitarbeiterliste
Filter=Filter
FilterByName=Name Filtern:
Name=Name
Surname=Nachnamen
DNI=Ausweis
Adress=Postanschrift
Country=Land
<<Prev=<< Zurück
EditPerson=Mitarbeiterdaten bearbeiten
Person=Angestellte
Career=Werdegang
Contract=Vertrag
Curriculum=Lehrplan
Pay=Lohn-und Gehaltsabrechnung
Presence=Gegenwart
ObjReview=Ziele Rev
Training=Ausbildung
Next>>=Weiter >>
PersonData=Mitarbeiterdaten
BirdDate=Geburtsdatum
CityOrigin=Geburtsort
CountryOrigin=Herkunftsland
AdressAd=zusätzliche Adresse
CountryRes=Aufenthaltsland
ContractDate=Datum des Vertrags
EntryDate=Zeitpunkt des Inkrafttretens
ExitDate=Datum der Abfahrt
Update=Aktualisieren
Cancel=Stornieren
mDNI=ID-Feld ist erforderlich
mBirD=Vogel-Datum ist erforderlich
mCitB=Stadt Herkunft Pflichtfeld
mCtrOr=Land Pflichtfeld
mName=Name ist erforderlich
mSname=Nachname Pflichtfeld
mAdr=Adresse ist erforderlich
mConD=Vertragsdatum ist erforderlich
mEntD=Eintrittsdatum Pflichtfeld
OrgreaIndexPage=Organisationsbereich
Organization=Organisation
Chart=Organigramm
Resources=Technologie
Languages=Sprachen
Users=Benutzer
OrgTable=Organisation Tisch
OrgData=Unternehmensdaten
OrgCode=Organisation des Kodex
mOrgCode=Feldcode ist erforderlich
OrgNif=Organisation Id
mOrgNif=Feldorganisation ID erforderlich
OrgName=Name der Organisation
mOrgName=Feldname ist erforderlich
OrgAdd=Postadresse
mOrgAdd=Pflichtfeld
OrgAdi=Postanschrift Cont
mOrgAdi=Pflichtfeld
Telephone=Telefon
mTelephone=Pflichtfeld
OrgWeb=Website
mOrgWeb=Pflichtfeld
OrgEmail=Email
mOrgEmail=Falle erforderlich
mOrgCtry=Pflichtfeld
mOrgCity=Pflichtfeld
OrgDate=Gründungstag
mOrgDate=Pflichtfeld
SelectLang=Sprache auswählen
Useddltoselect=Sprache auswählen
CharCode=Code Abteilungs
mCharCode=Pflichtfeld
CharName=Name des Dept
mCharName=Pflichtfeld
CharDate=Erstellungsdatum
mCharDate=Pflichtfeld
CharAdress=Adresse
mCharAdress=Pflichtfeld
CharAdressad=Adresse
mCharAdressad=Pflichtfeld
CharTel=Telefon
mCharTel=Pflichtfeld
CharWeb=Webseite
mCharWeb=Pflichtfeld
CharEmail=E-Mail-Addresse
mCharEmail=Pflichtfeld
CharCity=Stadt
mCharCity=Pflichtfeld
CharCtry=Land
mCharCtry=Pflichtfeld
CharHName=Name des Direktors
mCharHName=Pflichtfeld
Code=Code
Head=Direktor
CharData=Organigramm Data
AdChart=Fügen Sie ein Organigramm Bilanz
EdChart=Bearbeiten einer Organigramm Bilanz
AdRChart=In Rol zu ordanization Abteilung
Org=Organisation
CharHeadId=Abteilungsleiter
Unauthorized=unbefugt
PleaseLogin=Bitte loggen Sie sich ein
Logoff=Abmelden
Username=Nutzername
EnterUsername=Geben Sie Benutzername
Password=Passwort
EnterPassword=Passwort eingeben
_Login=Login
_Logout=Logout
Logout=abmelden
Login=Anmeldung
Forbidden=verboten
UsrData=Anwenderdaten
UName=Benutzername
ULastName=Benutzer-Nachname
AddItem=Artikel hinzufügen
AdUser=Nutzer hinzufügen
EdUser=Benutzer bearbeiten
UsRolData=Benutzer-Rol Daten
RolName=Rol Name
AdRol=In Rol
FDescr=Beschreibung der Einrichtung
FCode=Einrichtungscode
FType=Art der Anlage
FCrDate=Erstellungsdatum der Einrichtung
FSuperf=Einrichtungsfläche (m2)
FCostMin=Einrichtungskosten/Minute
FStatus=Anlagenstatus
FStDate=Statusdatum der Einrichtung
FAcct=Einrichtungskonto
FacilitiesData=Daten der Einrichtungen
FLotoAss=Zuzuweisende Standorte
FStAss=Zuzuweisende Speicher
FEdit=Bearbeiten Sie einen Einrichtungsdatensatz
FWCAss=Arbeitsplätze zugeordnet
FWCtoAss=Zuzuweisende Arbeitsplätze
FCrea=Fügen Sie einen neuen Einrichtungsdatensatz hinzu
-----------------M=--------------------------MATERIALS DATA
MData=Materialdaten
MRefer=Materialreferenz
MDescr=Materialbeschreibung
MClass=Klasse des Materials
MType=Materialtyp
MStatus= Materialstatus
MStatusDate= Materialstatusdatum
MDim1=Abmessungen #1
MDim2=Abmessungen #2
MDim3=Abmessungen #3
MWeight=Gewicht
MUN=Maßeinheit
mValDim=Geben Sie eine gültige Dimension ein (>0)
mValWei=Geben Sie ein gültiges Gewicht ein (>0)
mReq=Pflichtfeld
MCrea=Fügen Sie einen neuen Materialdatensatz hinzu
MEdit=Bearbeiten Sie einen Materialdatensatz
-----------------A=---------------------------ABOUT 
About=Über
AboutT1=myERP ist ein Open-Source-Projekt, das versucht, ein MRP-System zu schaffen, das sich an kleine und mittlere Unternehmen richtet
AboutT2=Vigo-Winter 2021
AboutT3=Kontakttelefon: +34 616454045 
AboutT4=mail kontaktieren
AboutT5=Besuchen Sie den Schulungskurs myERP
-----------------U=----------------------------USUARIOS
UserLoginName=Benutzername
UserFirstName=Vorname
UserLastName=Familiennamee
UserStatus=Status
Reset_Pw=Passwort zurücksetzen
UsrRolData=Diesem Benutzer zugewiesene Rollen
SelectEmployee=Einen Mitarbeiter wählen