Home=Home
Privacy=Privacy
HRArea=HR Area
Purchasing=Purchasing
Sales=Sales
Engineering=Engineering
MRPPLanning=MRP Planning
HRAreaIndexPage=HR Area Index Page
PersonTable=Person Table
Filter=Filter
FilterByName=Filter By Name:
Name=Name
Surname=Surnames
DNI=ID
Adress=Adress
Country=Country
<<Prev=<<Prev
EditPerson=Edit a Person
Person=Employees
Career=Career
Contract=Contract
Curriculum=Curriculum
Pay=Payroll
Presence=Presence
ObjReview=Objectives Rev
Training=Training
Next>>=Next>>
PersonData=Person Data
BirdDate=Date of Bird
CityOrigin=Birthplace
CountryOrigin=Country of Origin
AdressAd=Aditional Adress
CounntryRes=Country of Residence
ContractDate=Date of Contract
EntryDate=Date of entry
ExitDate=Date of exit
Update=Update
Cancel=Cancel
mDNI=ID Field is required
mBirD=Bird Date field is required
mCitB=City Origin Field is required
mCtrOr=Country Field is required
mName=Name field is required
mSname=Surname Field is required
mAdr=Adress Field Is required
mConD=Contract Date field is required
mEntD=Entry Date Field is required
OrgreaIndexPage=Organization area Index Page
Organization=Organization area Index Page
Chart=Organization Chart
Resources=Technology
Languages=Languages
Users=Users
OrgTable=Organization's table
OrgData=Organization's data
OrgCode=Organization's Code
mOrgCode=Field Code Is required
OrgNif=Organization's Id
mOrgNif=Field Organization ID is required
OrgName=Organization's Name
mOrgName=Field Name is required
OrgAdd=Postal Adress
mOrgAdd=Field is required
OrgAdi=Postal Adress Cont
mOrgAdi=Field is required
Telephone=Telephone
mTelephone=Field is required
OrgWeb=Web page
mOrgWeb=Field is required
OrgEmail=email
mOrgEmail=Fiel is required
mOrgCtry=Field is required
mOrgCity=Field is required
OrgDate=Foundation Date
mOrgDate=Field is required
SelectLang=Select language
Useddltoselect=Please Use drop down list below to select desired language
CharCode=Code of Department
mCharCode=Field is required
CharName=Name Of Dept
mCharName=Field is required
CharDate=Creation Date
mCharDate=Field is required
CharAdress=Address
mCharAdress=Field is required
CharAdressad=Address
mCharAdressad=Field is required
CharTel=Phone
mCharTel=Field is required
CharWeb=Web site
mCharWeb=Field is required
CharEmail=email address
mCharEmail=Field is required
CharCity=City
mCharCity=Field is required
CharCtry=Country
mCharCtry=Field is required
CharHName=Name Of Director
mCharHName=Field is Required
Code=Code
Head=Director
CharData=Organization Chart's Data
AdChart=Add a Organization Chart Record
EdChart=Edit a Organization Chart Record
AdRChart=Add Rol to ordanization department
Org=Organization
Unauthorized=Unauthorized
PleaseLogin=Please Login
Logoff=Logoff
Username=Username
EnterUsername=Enter Username
Password=Password
EnterPassword=Enter Password
Login=Login
Forbidden=Forbidden
UsrData=User's Data
UName=User's Name
ULastName=User's Last Name
AddItem=Add Item
AdUser=Add User
EdUser=Edit User
UsRolData=User's Rol Data
RolName=Rol's Name
AdRol=Add Rol 