
Home=Maison
Privacy=Vie privée
HRArea=zone RH
Purchasing=Achat
Sales=Ventes
Engineering=Ingénierie
MRPPLanning=planification MRP
HRAreaIndexPage=Index Zone RH page
PersonTable=Liste des employés
Filter=Filtre
FilterByName=Filtrer par Nom:
Name=Nom
Surname=Noms de famille
DNI=Carte d'identité
Adress=Adresse postale
Country=Pays
<<Prev=<< Précédent
EditPerson=Modifier les données des employés
Person=Des employés
Career=Carrière
Contract=Contracter
Curriculum=programme d'études
Pay=Paie
Presence=Présence
ObjReview=objectifs Rev
Training=Formation
Next>>=Suivant >>
PersonData=Données sur les employés
BirdDate=Date de naissance
CityOrigin=Lieu de naissance
CountryOrigin=Pays d'origine
AdressAd=Adresse supplémentaire
CountryRes=Pays de résidence
ContractDate=Date du contrat
EntryDate=Date d'entrée
ExitDate=Date de sortie
Update=Mettre à jour
Cancel=Annuler
mDNI=champ est obligatoire
mBirD=champ Date est nécessaire
mCitB=Ville Origine est obligatoire
mCtrOr=Pays est obligatoire
mName=champ Nom est requis
mSname=Nom est obligatoire
mAdr=Adresse est obligatoire
mConD=champ Date du contrat est nécessaire
mEntD=Date d'entrée est obligatoire
OrgreaIndexPage=zone Organisation
Organization=Organisation
Chart=Organigramme
Resources=La technologie
Languages=langues
Users=Utilisateurs
OrgTable=table de l'Organisation
OrgData=Les données de l'Organisation
OrgCode=Code de l'organisation
mOrgCode=Code de champ est obligatoire
OrgNif=Id Organisation
mOrgNif=Champ ID d'organisation est nécessaire
OrgName=Nom de l'organisme
mOrgName=Nom champ est obligatoire
OrgAdd=Adresse postale
mOrgAdd=Champ requis
OrgAdi=Adresse postale Cont
mOrgAdi=Champ requis
Telephone=Téléphone
mTelephone=Champ requis
OrgWeb=page Web
mOrgWeb=Champ requis
OrgEmail=e-mail
mOrgEmail=Fiel est nécessaire
mOrgCtry=Champ requis
mOrgCity=Champ requis
OrgDate=Date de fondation
mOrgDate=Champ requis
SelectLang=Choisir la langue
Useddltoselect=Choisir la langue
CharCode=Code de département
mCharCode=Champ requis
CharName=Nom de département
mCharName=Champ requis
CharDate=Date de création
mCharDate=Champ requis
CharAdress=Adresse
mCharAdress=Champ requis
CharAdressad=Adresse
mCharAdressad=Champ requis
CharTel=Téléphone
mCharTel=Champ requis
CharWeb=Site Internet
mCharWeb=Champ requis
CharEmail=adresse e-mail
mCharEmail=Champ requis
CharCity=Ville
mCharCity=Champ requis
CharCtry=De campagne
mCharCtry=Champ requis
CharHName=Nom de l'administrateur
mCharHName=Champ requis
Code=Code
Head=Réalisateur
CharData=Les données de l'Organisation Graphique
AdChart=Ajouter un organigramme Enregistrez
EdChart=Modifier un organigramme Enregistrement
AdRChart=Ajouter Rol au département ordanization
Org=Organisation
CharHeadId=Chef de département
Unauthorized=non autorisée
PleaseLogin=Connectez-vous s'il vous plaît
Logoff=Se déconnecter
Username=Nom d'utilisateur
EnterUsername=Saisissez votre nom d'utilisateur
Password=Mot de passe
EnterPassword=Entrer le mot de passe
Login=Connexion
_Login=Login
_Logout=Logout
Logout=se déconnecter
Forbidden=Interdit
UsrData=Les données de l'utilisateur
UName=Nom de l'utilisateur
ULastName=Nom de l'utilisateur
AddItem=Ajouter un item
AdUser=Ajouter un utilisateur
EdUser=Modifier l'utilisateur
UsRolData=Rol de données utilisateur
RolName=Nom de Rol
AdRol=Ajouter Rol
FDescr=Description de l'installation
FCode=Code de l'établissement
FType=Type d'établissement
FCrDate=Date de création 
FSuperf=Surface de l'installation
FCostMin=Coût / Minute
FStatus=Statut
FStDate=Date d'état
FAcct=Compte
FacilitiesData=Données sur les installations
FLotoAss=Emplacements à attribuer
FStAss=Stockages à affecter
FEdit=Modifier un enregistrement d'établissement
FWCAss=Centres de charge affectés
FWCtoAss=Postes de charge à affecter
FCrea=Ajouter un nouvel enregistrement d'établissement
-----------------M=--------------------------MATERIALS DATA
MData=Données du matériel
MRefer=Référence du matériel
MDescr=Description du matériel
MClass=Classe de matériel
MType=type de materiau
MStatus= Situation matérielle
MStatusDate= Date d'état du matériel
MDim1=Dimension #1
MDim2=Dimension #2
MDim3=Dimension #3
MWeight=Poids
MUN=Unité de mesure
mValDim=Entrez une dimension valide (>0)
mValWei=Entrez un poids valide(>0)
mReq=Champs requis
MCrea=Ajouter un nouvel enregistrement de matériel
MEdit=Modifier un enregistrement de matériel
------------------------------A=-------------------------------ABOUT
About=à propos de
AboutT1=myERP est un projet open source qui tente de créer un système MRP destiné aux petites et moyennes entreprises
AboutT2=Vigo hiver 2021
AboutT3=téléphone de contact : +34 616454045 
AboutT4=contacter le courrier
AboutT5=Visiter la formation myERP
-----------------U=----------------------------USUARIOS
UserLoginName=Identifiant
UserFirstName=Prénom
UserLastName=Nom de famille
UserStatus=Statut
Reset_Pw=réinitialiser le mot de passe
UsrRolData=Rôles attribués à cet utilisateur
SelectEmployee=Choisir un employé
----------------S=-----------------------------SUPLIERS
SupList=Supplier Relationship
NIF=Identification document
SupCode=Suplier Code
SupRaSoc=Company Name of the Provider
SupCity=City
SupCountry=Country
SuplierData=Data of the Suppliers
SupCrDate=Creation Date
SupAccount=Account
SupAdress=Address
SupAdressA=Address
SupPhonePhone number
SupemailFIN=email Finances
SupemailLOG=email Logistic
SupWebSite=Web Site
SupEDIFIN=EDI address Finances
SupEDILOG=EDI address Logistic
SupBankAcc=Bank account
SupStatus=Status
SupStatusDate=Status Date

